11111111111111111111
100P1C0C0110CE011001
10CC000010C0C0000001
1100C1010110C0101001
10001111C00111101111
1CC010000000000C0111
10C1C101CC000C100CC1
1001000001CCC001C001
10100110C0C0010C0001
1000C0000C0001011C01
110C0C00C01C110C0C01
101010000000001C00C1
10C1000100101CC00101
1000CC0C010000CC00C1
11111111111111111111