1111111111111111111111111111111111111111111111
1C0P0E0000000100CC1C00000001010000C1010CC00011
1011100001CC00C10001100100010C001C010C100C0011
100C100000010001100C0011C010CC000CCC00C01000C1
1CC000001000010000010C10C0C110C000C010C0C00011
10CC0C0101CC00000110CC100C111C0000101110C01001
100C0010C01000001C0100011C010000001CC10CC000C1
11C1C00CCC0C010000010C001C10CCC1C000101010C111
1000010C100000000001000C011C000CC0C00C10CC1001
1000001C00100100100C101000100000C000C100011101
11C001010C001CC0000000C0000000CC000000001C00C1
11011111000010C0000C000010000C0011000000C10001
101C0000101100001100C000010C1CC000000CCCC0C111
100000000000000C010000C00000001C10110100010C11
1000010010100C000C0C111000000101C110CC10000CC1
1010000C110011010C1C100CCC0101C00C010C0100C001
1C0C01000C000010C0010010C0C00000C000C0CC01C001
100C0C0000001010010C000001000000000C010CC0C001
100000C0101100C000CC00C001CC00000C0C0010000001
1C11101C00CC0000C01001100C0CC0000000C0C0000001
1C000000C00111C1000C0C00CC00010C0C01C0000C0001
11C00C000CC1CC0C001111CC1C00C0001C10C0C0000001
100000010CC00CC000C1CC00001110000000C001CCC101
101000C0C1000010C0C10CC1101C00001CCC0000000CC1
10010000001000C000C10C0C110C00010CC00100000011
1000000C0C0100C01C1C00010000CC00100101C00C1C01
1C00CC0101000000C00001100C0100C001C00000000C01
1111111111111111111111111111111111111111111111