11111111111111111111
1C1PC110100CC1CC0001
1CCEC10C010C10C00011
10C001C00C1CCC1CC111
100001001C0C1C1C1001
11C0C11C000110110101
110C1110111001CCC001
1C1000CC1C01C0CC1101
11C10CC11C0101CC11C1
1CC001CCC11C010C1001
1101CCCC11C10CC0C111
1010CCC0CCCC1CC00111
111C10C11CCC11010001
1CC0101C100CCC0C1111
11111111111111111111