11111111111111111111
110PE0001011CC0C0CC1
1C0C001001111CC01001
1CC0C110000C1C1CC001
100C001010CC0C1C00C1
1101C0C0C110010C1001
1C10CCC100C010100011
110011CC1CC100100001
100101C01C1CC0C11101
101C1C01101C0C001101
1C00C0C1C000CC0CC001
1C10C0CC1100110C1001
10100C1C111000C1C1C1
1101CCC1111011C00101
11111111111111111111