1111111111111111111111111111111111111111111111111111111111111111111111111111111111111111111111111111
10CC1000E10000C1C00CCC0000PC10C0000CC100C0CC00C00110CC01C0000C00C0000C00CCC0010C01C00100000101C000C1
1100000C01C01C100100101C0CC00C100101000C10010C1100C0C001000C00C0010010C110000C10000010000CCC11000001
1C11101011C000100C000CC00010CC011111C0001011C00010C010C00000001C0C1100C11001000001C001CCC00010001001
10C001C0C00000001C110110C000C0CCCC110110C0C0000C1100000000000C0C1000100CCC011000C100C00C1000110001C1
1CCC00111C00000C11100000001CC0C0001C11C101100000C1010C0001C000C10C00100C1C000001011000100101C111C001
100C110001000C0000CC0C1000C010010C11000C00C00C100000100CC1C11000C010C000000100010001CC1CC110C000C1C1
1C100C0001000000C0000011011001110100011C1C1CC001000100C1C000CC10C0001C0011C101C1CC10000000CC000C1001
1010C0011C10110001C01CC0C0C0001000CC0C0CC101000100C01100100C01C00100000000C1001001CC0000011C0001C001
1C000110000CC0C010001000010C00001000CC1000001C000C0C11100C00C0C10CC0C00010000000010000C101C1C0000001
100C00001001C0CC1C0C0100C00010C0C00CC10C100010000000000100000CC10000C0011101100100000C01CC1011000101
1100000C0C00C000C000C0010100001C0000000000010C1C11100000C1001C0CC0000000000C1C01C011001010001001CC01
1000100CC0000010C10000101000000111000000001010C000C00001CC00C0C001C110C0010C10C0110001000000000001C1
1C10000101C101001001100010111100C010C000011C010C0C000C0001000001C10000C0C000C1C1CC0000C100C001C11CC1
11C0001C01100101010C10C00000000C010C0000010010C11C0C011C1010001101000C01C000010C011010100C000C000011
1C10100C000001001000C01CC0100CCC0C00000CC000001CC0CC1C0101000000C01C0000010CC1CC00C1000111CCC0000001
1C0C000100000C00100100000C0000100C1100011C100C011C100010CC00C0C01011C00010011010C000C100CC0001000011
11001110000C000CC000C1000CC111100000CC00C0000C0000100000001CC0000C0C10001CC10C0001000C0C00C0001C0001
100001000010C01100C000C10000C0C1001010C100C100C0100100001010100000000C0001C0000C00C00C00100C00000001
100010101000010C00C10C00C0000000C01000100100001000000C000C0001C000C0C01001CC101000000010000000100111
100CC1C000C1010000000CC001000100101C00000C1CC01001000110CC01000C01C010CC10C0C1C0100011C1010C00110001
101010000010010000010000C111011010001C000C1C0CC000011C001C0CC0010C00101101C0C10000C00C0010100C010C01
1010100000C100C000C100101011101C001CC1CC010111C10C000CCC00CC10CC1100011001C1C0CC000010C0101CC00C01C1
101C101000C11000C0100C01001C1000C00C000C1CC00010000010110100C0000C0001000C00C00000CC0100110011000011
100001C1010100101000C0101000001CC10000001CCC111000000000001C0C0001C0000C000CC1CC0000C1000C0C00000011
1C0C110011010C10000C000C00C0100100000C1000C00100C000010C0000C0001000000CC0100100CC0000001C0C01010001
1C00011C00001010000C1C000C00100C0C11C00000C0010C001100001C110000C000CC00CC010000C00C01C0CC00C00CC001
101000110CC10C10C000C0C01C010010000CC0CC0C1C0C1001C010CC0C00C0CCCC1C1C01C1000000C0001C010C0C0C000C11
101CC00CCC000000100CC00010000101CCC0000011001100CC0C000CC01C0C00010010010C1C1000C0100000000000001C01
10110C000011100011C00C0C10C10000100010010000000000000000C1000C0010C000C0CC000000C0C1CCC000C01CCC0001
100100000C0C1010000000000000C000110001C010101100C00000000C01C1C00011001000101C0C01C1C1C00101000C10C1
1C10101CC0C0C0C0C11C000000C100CC0C0101C1010101C000C010001C0C10011C100000001000001000CC0000100CC0C101
11100C11000000001000101011110C0000C000C000C001C0CC00C00C0C001C01000000010C1011C00C00000CC100001000C1
10C01C001C0CC00100000000100000000000C1CC101000110C0000C0CC00C011C01100001C0C000C001111C0C101C0000101
100C1000101CC001000C0100100000010C1C0000C00C00C00001000C1C0000001101000C0C0C001100C0C1000100C0C00CC1
10C10CC0C00000100110010C0CCC111000CC010CC0C00100C000CCC0CCC00C100CC0C000110C000000C1C0000C00011000C1
1C0001000C0C0C00010CC000C0C1C1000C0C00110010CCC1CC101CC0100C01C00000110100CC010CCC10C001C00C00C00001
1100C1C0C0C01000CC101C00C00001C10100000C010101000000C00010010100100C0C01C000C1C01011CC00CC00101C0001
11C0C001000C1000C000C0000011000000010000010011C0000C0000000000CCCC00C000C00100C100C00000000100000CC1
100C00C1000C10011C10001C1000000C001000C010000000C00110000C0C0010000010C100C00010101001C00010000C0011
10000CC100C000000C00C0C0C00C00000000C1C00000C000CC00CC000000C0C1C0100C100100CC00C0000000C1011010C0C1
11010C00CC00100011C0CC000011C1000C000100001000C00C1CC000110C0C00000000000001C001001C100C1CC01C00C0C1
1C00C11010000000000C100001010C10100C00010000000CC000010100CC010C10C00000C01000C0CCC010C01C0000CC00C1
10010101010C00C0101C0000100C011C000C0CCC0C0C000C00000CC000110CCC00000C1011000000101CC0C0110CC0010011
1C0000100C110100000000C100CC0C01000C1C1100010000000CC00C1010000C100011C110C0CC0100010000010000010011
110101C010C00001000001010000010000CCC001C0C100C000000010000C000C0C0C0001000C0C10110000000001100C01C1
10000000000C00000001000011101100C000110CC100C1001C001C0C000000C0C000000C0001C100C100001C0C0000001011
1C0011C000C100010010001000100100100C000000110C0011000C01C01110100C0000000C0CCC010101C00CC10C10010011
1C00010000C0010C00C0100100001000010001000000010000000CCC00C00000011C00001C0C1000CC1C1C110010CC000011
110000C00000C0000C00C00000C000C10C11000000010C1CC00010C0CC0000C00101C011010C11C1000000C00C000000C1C1
1CC0CC1010C0CC1C1CC00C0C0000C00CC100000000101C0CC0001C11CCC00000CCC100101C010001C0C00CC111C00000C0C1
100101C0C1000C0C0010000CC0010C01001000001101001100100100C100C100110100C00C00C0010C0000C001001C001001
11001000C0CC0110001001000CC10C1C000000000C01C10000110100C000CC00001C00000C0C10C000C001000000CCC110C1
11CCC00CC000CC00C01001001C0C0000CCC1100C0000000010100C00C00C01C001C101110000C0000CCC00000C1C0C110001
1000C000010110C00010CC1110C000001000001C10C10000C000000C0010010C00000001C001100C100C00C001C0C1100001
1C110C000C00CC000000000010001000C000C00C010CCC00C00C00100000000CC00010C10100C11C000000C000000C001C01
1C00C0CC000C0C0010C011110000000100C100C0CCCCCC000110C001000001CC00010C1CC10001000010000100CC10000011
110001000CC0010000C100C00110C000C010010000CC00C0001C0C0100C01C0C00C11C000100010C1100C100C010CC00CCC1
10001C00001CC1CCC00100C0C110000C000001C110C01000C11C001C1CC10100C00000C10C11C000C00010000000C0101111
10000C00000010CC010C00C00010C1000001C1001001C01C00101010CC00C110000C010100111C1C10C01C00000100C1C111
1C0000CC1000100C010001C01000001CC1C000001000C0000C000CC0C000001C0010C0000010CC0010111C00001C0CC01111
10100CC0000C0001000100C10C0000C00111C101CC010C110C11100101C1C01C0100010C10110010010001C0011001C00C01
1001C10011011001C001CC0001C000C01C101000C00C0C00000CC10100001C00C0C00101C00000001C100000000100C0C001
100C1000101100100C100C0CC10100010000010010100001000CCC001001100000000001110001001000000010C1C0001011
10000C0100000C001C00C0C000C1000C00000011001000C010000000000001011C0C00001000010C10C0C11C00000CCCC011
11100001011CC11C000110100100000C01C110C00C0C0000C0000C0100001100CCCC0C00110C00C0010C00C0010C1001C1C1
100C001000000010C0000CCC0C001111C010000CC11000C00000000000001001C1001000C01101CC0000C00C1C00001101C1
1C0C0C001C0000C001010001CC00000C0C00C0CC0C010C00C0000000001C011000C00101100000010000C0101CC100C1C001
11110000CC0001000C0101000010CC01001C1000101100010000000C1100C011001C1CCC001110C0CC000C00000C000C0001
1000000010010C000C010001011001C0C000011110110CC0000101000000000C1C1111C000C0C10000101C01010CC0110001
1CCC00000101C0C10C0100111010000000C010CC00001C0101000C0CCC10C1010110C01C10010C0C100000101C00010C1C11
1C0C000001C00CC0C100101001100CC10C00C00001010C1000010C000010000C1CC0000001C010000C00C0110000C0C10C01
1C0CC10000000010100001C0100000101C010C1CCC0000C0CC00C00010C0000CC1000CC0000000000100000C01C0000C0001
100CC000C0C00000000001C10C000C000C01001C010000C00100C0C0C1000101000CC1001C1001000001000CCCC1CC000001
11001C01010100000100CC0000CC01C0010000101000101C0110C0C0CC11000CC00001C00010C001C11010011C100101CC01
10110010000C000C000000010C10C00001000CCC01000000100110100CC00000000C00C0001C00010010CC010C0C01C00001
1C000100000C0C001C1100001011C00100110000000CC101000100C00000001100000C00C00000C00C11C0C0001000000001
10C1C000001001C00C10CC1CC00010010000C0101C1C01C1C10C01111100CC0C000CC10010C110C01000CCC0C0C00001C101
111000010010C100111CC00C11C0111C000110001100C011C001001C1CC1C000000CC0C0100C00C10010C010C000001C00C1
1010C01C00000100000C000010C1C0001C00000000000C01CC110110000000C1101C010000000C000C0000C10CC000010011
1C010010100C0C0C010000000C0001101C00C00000CC0000000000011C0CC00C1010C0C01CC0110001C0C0C10C10000C0001
110C0C100C0000C00C0CCC01C110CCC00C0C1C000C100C11000001C0C0CC0C00C010C1011CC00C0C0000CC00011C000C0001
10110C0C11000001C00C0000C00CC1000100C100C1C000C11CC100000C100C000C00C0000C0C010C01100CCC0100000010C1
1CC100000C00000C000C10000001C00C00000CC10000CC0C010000000C1C001C01C0100000CCC000C11C0C1101CCC0100001
10C0011000C10C110C0110C0101C010CC0100100001000C1C1000000000011001C00CC00000C00100C000000001CC1000111
11000CC100C010C0000000000C1100CC00CC0000C0C1011C10C1C0C10C100C001010110100101000000000100CC00001C001
1CC000101C0011110C001000010CCC00CC0001000C000000000000011C11100100000010C000C0C1001000000CC11C00C0C1
11C100C0100C1C0CC0101C1CC10001100010010001C00CC00000C0C1000C00000C000C0010C00C01C01CC0C01C0000000001
1000C0000C0000000000000C0000100C0C0C0000C0C0C00C0C01100001C0110000CC011010000CC0CCCC1000001000000001
10C100011CC00001001100C100011000C0C10101C0110CC1100C0000CC00C0000000CCC0C1C0001C100000000100010000C1
100C000000001000000C1C001C000C0C010C0000C01C100000C0000000000101C0CC0000CCCC000010001100C0C00C011CC1
11CC1001110C00C011000011000010C10CC01001000C0000000C0001C001C0001CC000101001001C0000C0CC1000001010C1
1101C00000000C0C0000C0C0101000C0100100C0C000000000000C000000C0001000000000011CCC01000C000CC10C000001
100C0C000000C000100100C0CCC0010000000010100010000C00C0111C000000C0000001000000000000100C011100CC0CC1
1010C0000000C110C0C0C100C000C0C001000000011011000C1C1000C010C1001010C01010100C0C00C00C111C0C01010001
100C0001C0100001CC00100000000000C110000011CC0CC0C00C0000CC010111CC000C00C00001011000C000100000C000C1
101000011C00C00CCC100100000C000000000001C10C000CCC1000C000C00C10C00000000000010000C0001C010001011111
1C000C00000C0C00001CC0C100C10CC0C0100C00000001C111010010CC0101010C01010C1C000000C0CC0C010100000000C1
1CC000000C000C0001C1000100000000000000C001C0011000C00C000000C000010010C1001C011000C0100CC101CCC1C0C1
1111111111111111111111111111111111111111111111111111111111111111111111111111111111111111111111111111