1111111111
1010000101
10PE000001
1111111111