11111111111111111111
1E01P0000C0C0CC0C0C1
1CC1C1000111111011C1
1110C0C011C111C001C1
1CC01CC101CC11010C11
111011CC0CC1C00C1CC1
100010C10CC1CC11C111
101100CCCCCC1C1CC101
1001C00100C1C1C1CC11
1C01CCC1100C0111CC11
11C1CC11C11C1CCCC001
100100C11100C0C00011
1C0CC0C11001C100C001
11C0100C101101CC1001
11111111111111111111