1111111111111111111111111111111111111111111111111111111111111111111111111111111111111111111111111111111111111111111111111111111111111111111111111111111111111111111111111111111111111111111111111111111111111111111111111111111111111111111111111111111111111111111111111111111111111111111111111111111111111111111111111111111111111111111111111111111111111111111111111111111111111111111111111111111111111111111111111111111111111111111111111111111111111111111111111111111111111111111111111111111111111111111111111111111111111111111111111111111111111111111111111111111111111111111111111111111111111111111111111111111111111111111111111111111111111111111111111111111111111111111111111111111111111111111111111111111111111111111111111111111111111111111111111111111111111111111111111111111111111111111111111111111111111111111111111111111111111111111111111111111111111111111111111111111111111111111111111111111111111111111111111111111111111111111111111111111111111111111111111111111111111111111111111111111111111111
1100E00C1P00010C1C0100C0C000001C00100011C01CC10C011001C0C0C00001C0C0110010100C000010000C01C0C0C000C0000C001000000000C00011C001C0000010000C0100C0001C0000C000100C1C110C10011C0C01000C1000C100010010000C01000CC000110C011000000000001010CC00100100C00C001000C010110C0111000101000C01010001C1C0000000100000001100CC10000000C1010000001001C0000C1CCCC01C10C1C0110110000C000000110C0C011C0000C000C0C1000101100CC010000C1C000000001000C0C1C00111C1110C00100C1100C00110C00C00000C000C0C010C11C1000C000C01CC00C00CC101C1CCCC01C0C100110CC00CC0C000001C0C000000000CCCCC11001C0C00C0C000C10100C10000000000001C10C00C0C00000000000CC000100100000C0C00C001CC0C10000000CCC00C0000CC0001CC11001C01C00C0C10C00C0000CC0011C0C111CC00000000001C0C00C1CC00C11C00CCC0000C0000C00000C0C110C000000010000000CCC001C0011001101100CC1C100CC0000C0C0100C00000011001CC00000000C00110C0000C001C001000C0C000CC0C100C0000C000CCC00010C001000011000000CC010C00001000C00CC101001100010C11001000010000111C11101010C0C1C000001C1CC00000CC00C000110011001C0C01010000C10001
100001000000C011C00C011010101C000000000C0C0C0C1C0001000000111000C1C0001000100C000C01CCC1000011C1C0C0000000001C01000C11000C0000011C100000000C01C000000100C00C0000CC10C00C0C0CC010010C001000001C00000C0000C111C000C11C0100001C010000C0001011101000C1010010C00C010001000000001000CC000CCC010C10C0000001CC0111C00C0C00C000CC110CC00000001C0011CC0C10011100000001000110C001000000CC000000010CC100101010001100100000C110001CC010000C000110C00C0CC100010C000C00010CC0000C0000C010C00C10C0C000000C0C0001CC00100C1C0000000C00C0000C10010C000101C000000100C00100C00000C1011001CC0011CC100C00CC000C00C0000C1C010C1101000000111C0001C000C11CC0CC00110100CCC010000000C0C00000100C01C1101C00CC00CC00C1000100011000C001C001010100CC01010C11C1100000000C0C1C10100010000000000CC00C0C01000001000000C00100010001000000111C01CC0C1110100000C01C001010110C0000C001101C0001100000000C0C1CCC00C0CC010100C1C0011000000C000CC1101010010C00C0C001010C0000100101000C000000C0010000C0100C010001C1CC101C11CC10C101100C010111100000C000C0CCC101001000010C1C0000001101
100000C01110000000C010C100000000CC0010000011011C01C00C0001C0C0000C0C00C0111000001100C001010000C000000010100000CC0000100C0000C0001101C0C010C00C000CCC00000C000100CCC0001CC0C10101C0001001001C000011100C001C00001C001011C00C1C10C1000C0C0000CC00001C0C10110000100C0C0000000000000100111C0C0000101010011110011010C0C0100C000C0000CC01C0001C000000CC00100CC1010000C0111CCC01010CC000CC01010001000C0CC0C100011000001000C1100000CCCC0000C0C000000C000C00001001C00010000001001001C00C1000C000010110C000C0CCC100C00100000C10000010000100000010000011C101000000C000010000C01C001C00C01000C000001000C00C100010C0C0000CC0000100C1CCC11C0C00001C00000000000C00000010000010000C0100C00C0C00000101C0011011100101001000C1000C100CC100001CC00C0000C10C00001C00C0CCCC0101001011010000100010101C0001C00C0C0000C000010C1C000001010C1000C00101000000000C000011100000C11C000111010CC11000001110001000010C0CC00001CC00010000000C010000000C0C1C100C0100C010C0C1100000C0C0100100CC000C1C000C0010001000CC0C10010100C001100C000011C0001C100100CC10C00000CC00C00111
101100C000000C1C000001C0011100000011CCC00C0C10C0000C10101C01000C010110010100C0010C00C01C00001C000100001C101C10100C000C00C010000C0010001001010CC000011C10000010CC00001000C0C010000C00C101000C00C010000C0C00100001010CC1000000000000000000C000C00000100C01100010001C110C000001C010C0C0C1C0CC0000CC00C0000100110001010C0000001C0CC1010C01C0CC01001CC1C00000001000010101000001000C10001CCC00000C0C100001000001C001010000CC0010001CC001010C10000C0000C110C00C01000C0C10101C00C000C0C110000101000010CCC100000001101CC110C0C0000C0111C00010000C01001110111000C0000010C0101011011C0000C1001000C0C00CC1001C0011011000000010001000010111C01C0000000C0110000001000C0000000C0C0CC0100CC10C10100001C1C0CC0000CC1C0C1000C001CC1C000000C000010C10CCC10100000000000001010CCC11C001100C1110C001C0000011101100C00C10C010001000C0CCC10000010CC00C01001000C100CC00100C0C11100010C100C10100001000000C0111CC011CC10C0000001001001010CC01110CC0000000C0C00010C01100C100010C1001C0C0C001101CC000CC11C10000CC1001C00111101100CC0C001CC00000CC000C0C01CC0000010011
1C100C1100C1000000010001CC010010C000C0CC0C100001011C00000CC010C00C00110CC000001CCC01C01C10C0C0C0C01101010101101C00C0CC1000000110CC1000011000C1100111010C100C0110010CC00C00000000C00CC00C1010CC10C00C01010001010010C0CC00C1000C001CC01C1000C0C1CC01000C0C000000CC1000CC100000111000CC0CC0C11C0000C1101CC100001C10C00C0C0000C00C100C10010C100C00000C0000C0CC11000C00C0000000C0010C000010000C100001010C100000C000C00000CCC1C00000000000CC0010000C0C11C00C01101C11C00000C00C01CCC01010000C0C0C00C0CCC00100C0C0010C001100C0C010000100100100CC000000001C0000000CC0CC100010010CC00C000C00C11100000C0CC001010C00100C0100C00CC001CC000C100CC00C001001000000000100100C0011C001010C0000100C010C11000100000C001C0C00C000CC0C011CC0001010C100CC100C0CC0000001100C110C000000C01C10C100000010C10010000CC0001C10CC000000C10C001C011CC110C00100CC0100CC10000000C0000CC010000001C1011100010001011CC00000110001110C00010C11C11CC0C00C0001C000C0000C0010001CC0111100C0C1C010C0000000C0010000C0C1000000C00000000000000011C00CC100101000C1000100010C00C0000101
1001100C0000010000000001000000000C10C110000100CC00000C100100000000000C00C0C0001C10C010001CC000C00101C00C00C0000C0C0CCC0C1C0000001C01CC00C000011100011010CC000C0C0010000C0CC000C0C100010110C00C00011C0100000000011C01C00C10010C000C0C011C100C00CCC0C0000C1000C11C00000C000C0000011C01C1CC0000000000C0C0CC00000C0010CCC0000100000C1C000C00C000001CC000C000000000C00000110C0C11000CC000010CC10110010C00000001C0010101C0000101111C010110C00000C0000C00001010CC00CC01100C100000C0C000CC00C100C00CC0000100C010000CCC00000100000000C1C000100C0C1C1001C01000001C1100C00C1000001000000000CC1001000110100100C10100000000C00C1000100C0001C00C0CCC010C0010C0C0111C00C0000C0100000101C110CC1C00000000001C1C000CC1C0100100101C00C000010111C0000000C00011CC100C1000C0000CC000000010000000C0010C0C0CC10C00C1C100C0100001001CC01CC000CC11C011000101C01000C0000000C000C0C0010C10CC0CC110C0C000C000C001C00001CCCC000000C00C0000C0000000001001CCC000010000010100000000C0000C000C00C001110CC110C0001011101CC0010100100CC00C01000100CC000C0010C0C0100C01010001
10000CC10000C100000001C01000C0CC1C0000000C0C001000001C001C000110CCC100C0000C1C0C00C000000010000C1CCC00C100000C0CC1C00000C00CC00000C11000C10C100110C0CC10000010C00100010010001CCC00100000100100110000C000101011C00C100C0000C000C1001101C101C0100CC0000C00100010C0000000C100110C00C110CC0CCC000000010011C100CCC00000010001C000100C11011CC0000010001C0010100C0000010011100101000001C000C10000000100C00100C000C1C0C00C0C100C0001000000C1C00000000C0C01101100CC0000C00000000CC0C001001C0010C01000CC0CC01000001C00000C100100C0000000101C1000000100CC0000000CC000C0C00100100100CC00C0100011C11C000001C1001C0CC0000C1100001C001000CC1010000110C0CC0010C101010011010C001110C010011C1001010CC1C0000C0C000101CC00001C0C1C00000010C0C0C00001C000C00010111CC01000C0C0CC000CCC010010000000001C0C001101C00C0010000C00C010000C01C0110C0100C0C10100C011110010000000C0000000010C0C01C10CC0C00000110CCC001CCCC01000000000C01CC000010000000010100CC10101C0C11C0000CC001000C0000001000100000C00001100C0C0000001001C0010C00CC0C000000CC100100C1100C001C0C10001
1110001100000011001000C10000C1100011C001C1000C00111000110010C00000110C001001C100000C00011000C00001100010C00C0CC001CC000CC0100001C000CC010000C000100101100001C1C001100001C0010C001C00101C000C00001010000CCC010000100C1010010000C00101C00C0C00C0C00C0010CCC0C0000CC010001CC1C000101001C1CC01C01010C0000C00C0000000C10110010C111001000CC001000100000C01C001010101110010010CC0101C1001C100000C00000010C0C00C01C01C000C1C00000000C0C0C100100000C0000011C10C00001000C10C0C10C0C01CC00CCC0000C0000CC1000000000C0C00C000C00000C100100C1C000C001011000100000C1C1CC0C1C0C00C0CC00C00000010C000000010101000110110000C100000100C10110C10100010000C001CC0CCC1CCC0CC0C00010000C00C0010001000010110001001C0C000C11000000010100001000010C00010010000CC0C0CCC0011100CC0C100CCC0110C001000100110001000CC0C010C00000CC00C00000CC000CCC0000100C001C10C00010100001000C01100101C110011C00000C0C0C00C01CC1000C001C000C00CC10100000C000CC00001C00C000001C0001001000C1010000001C00011C0CC00C00C0C010010010010001C010C10C000C00001C010C1C10000C1000000C010CC011101
1C00C011CC0100CCCC00000001C1C010000000010C0010CCCC0010000C00C100010000000000C0000111101C01101C00101010000C0C0C000100100011000C00C01C000000C0C100C001C00C1C0C01000C000010C01000001111000000000100010CC00100C00100C11010100110CC00C0100011C0100C11C001100C1010C0000C10010C011000C100010C0010100000C000C100C01001000C11C00110C01000CCC0101CC0110000C0100C0CCC0C01C0010C001C010C1C0C10100C100010C01CC1CC1001C00010000CCCC1C00C000CC0010C000CC100100000C1000100C0C000C1000100000C0C0001C10C0110010C00100001C1C10101110010C0001CCC00001000C1C000000010CCC010000CC0CC0C0001001C10000000CC1000010000000110C001011000C00000C00000C0C00C000010000000C00C1000111C010C0100010CC0100000C00CC0000CC000C000011001010010C0C1C000000100000C0C0100000001C1000101000001C000CC00C10000001CC000000001C0CC0C00C000C0100C000C100C0101000100CC1C10001000000100CC1C0C0C10100C11C0010CC10010100C00100110000C00000000CCC00CC0000C01C00C0C0000C0000000010C11C11000011C0000C00100110C0C0011000CCC001C0000100C01001001C0001100CCC0001CC10000000000011C10100C00C0000101
10C0C00010C10000001001000C00010C00CCCC01011CC01CCC001C11CCC00CCC00001100001000C0000CC111000001001000000000001010001010C0000000C000101C000C00001000C00100C00C0001000100CC011C0C0000101000C0010C0000000110000010C0000C01C1C01C000110010C010C1010000C000000010C11C000C0C00010C110000C110C010C00000101C0010110101010001000100C10000000CC00C000100001000000001110110000000C0C1000000C0001C11CC11C01010001000010000010C000000C100C000000C10000C00000C0C10C11C01110000CCCCC00CC01C110C01001000010C11000C1CC0000000C0C000C11001C10C1C00C0C001100CC100C110CC01C0011010C000C0011CC0100C01000CC10000C10000C001C101011100C0001000C0000000C0000C01C001110CC01001111011C0110101010C00101C000C0100C01C01001010000CC0000C0110C00000000C0000C01101C1111010100000010100000000000000000000C10C0C1CC101C00C000C0000100011CC1C0C101C0000C11C01CC000110C000001C000010000000000000C00C0C1000C001C001100C0CCC010001110000011000100C000100C0000001010CC1000010C0000010C10000100C001C0001010C00100010101C000C00C1000CC01C00111010CC0010001001C001CC010000000001C01
1C0C00000C000C0C001C001111C000C100100C100CC1C0001CCCC0000000C01CC1000001C010C0000001001C00000C10000100C01C01C0000C0C0C1C0C10C000001001100C1C000000100110C0C0101CC0CC0C000C10C010000000CCC1011C00C0CCC000010C01000C01C01C0C000C00001110000000CC00000100100100CC000000C0CC10000000000C010100C010000001CCC00C000001011C00C110C01C0C000C00000011010C1C100C10001000011100100C011C100C001100010010C011CC0100000C01CC10000000001001001C000C0111C000011CCCCC01C100C011011C00C00111C0C000C0C01000000CC001001000010C1101CC11000100C0000CC001000010000000000010100000100010C10C0C000100C00001100C1C000C001C000C11001C1001001001000110000C1010C0000C01100C00101000001C00100C1C000000000001C1CC0C1CC0001100C0C000000100000011001010100C001011C000110100010C01C0C0000010001000C0C00C0C00C0100000C10000CC010010010001010010C0000100000000C0000100C01100110C01110C000C000C00C0100C0C00111001100000010CC010001C01000111010C0001000100CC00CC1100CC0010CC0C00000010001CC000C0100C001CC0000C00010001000C001100100000100CC00000CC0C000C001CC1010C0C000C0CC0C1
110CC101110101C001C1C0CC00000C1C1100C1011C0CC00000C000001C000000C00C001000000000CC0011000000000000000010C00011C0C00110C0CC0000C00CC000C10001C01C00000CCC00010110C00001C010000C01010CCC00000C00C0001000C000100010000C0CC110000C000001110CC00001001CCCC001000100C00000101000000010C0C00C0001010110C00010000CCCCCC01C0CC00C001C0C0C1C000011CC1C11001C01110000C0C0100001000110C00010000C1010C10000C100C0CC0110C100C0010000C00000C0100100101110011000C100C0000C11100C01C0000CC00000C00000C0C0C0000CC0000011C0000C110001CC1C0CC1011C101010100000001000000CC100011000011110CC010C0C1000000C110CC0CC1CC00C000CCC0C10C0000C000C1100010C0CC00C000100000C1CC0C100C010000C0CC000010100001001100100C001C10110000010110000C000000C0C00C0100C1000000001111000CC10C00C0CC0C000C0C01000010001001CC01C0000C010C00110CC00CC101110C1010000011000C000C01010011C001C0010C001000000C0111000100000C0C0000000C00010C01101C0CCC010000C000C0000C1C01C1000010001C001000100C000C1C1001000CCCC010C0100CC01000000100001CC000001C000001101010001110C001000CC001010C0C011
10C0C100CC000100000CC0000000010C000000C00C1C01010001000010000CC0011C001C0C000C000000010100CC0001CC010111000000010C1010000001C0C011001000CC0000011C0001001C000001000000001C01CC100110C0CC00001000110CC0111CCC01000C10C00001CCCC0010001C00CC1CC10C00000C00C0CC000C000010100000C0CC100C100011000C000001110CCCC1CC000C1000C1000110C10111000C1101CC00C11011C1000C0100CC11010000000C0000C0CC111000000100011001000C00C000011C000001001C1C0C10CC10C0C0C0C0100100CC00000C00000000100111000101100001011100000000000C101001010C10C0001C010010010010C10C1000000000C010CCC000100C101110C01C01CC1100C001100110CC000100100C0100001C0C01C00001CC110C01010C0101000100000CC00C00C10CC00000C0C01C00001010000000100000C0000C10CCCC01100100100CCC0110001100C00C00000010000C00000100CC0001000000C00010C01C000C00C1CC0000C000C0C001000000CC001CC0000010C0C001C0010000001C000CC000C00000CC00000C0010C10000C100C000C00C000CC00C0C0000000CC0C0CC10C00C01000CC00CCC000011010001CC10C00000CC00C0C00CC10C0010000011CC100000C1001000C00000000C0C00CC01000C01001100C001
100C0110000CC00000010010C0CC00001C00001C1C0C00000C0001000C1000C01C0100C000C110C1C10100CCC10001CC000000C0100C000000C10001011C00101101001C1C011C1100C000C1000C10110000000000100C0000C1000010CC1000C11C00001100C10C01C00C101C000110C00C000C010000000C0C0100000011CC1000C1101C0C100000C0CC00C000C00C0C00000000001010C10110011C10111CC000CC000C010010100010CCC10C010C0001C01001CC01100001C001001001C000011011C00000000C0101C0000000CC0CC0CC1CC00110C0C00100000000000C00100C01101010CCC00000C000001100011001010C001011CCC000110100C1010CC001000000000000C00100000C0001CC0110011000CC0CC000000010000C001C00001C000C000C11010C00100CC110010C0C0100001C0100000C1C000001000C001000CC00001000010001110C10000100000000111C0C000C0C1CC00000C0100001000C1100C00C1100C000100C0001010C0CC00C101110C01C01000000011C0010CC0C10000C00100011001C1001C0C0C001000001C1C01100C0011000C00CCC1C10011001CC10C0110C0111C000010010CC00001C00C00000010C001C0000100C0010001C0CC000C000C00C0CCC00CC110C00CC00C0001C001CC0000000010000C0C000CCCCC11000010000C000C00C01C1
1C010000C00101001C0000C1000100C0C010C10000CCC00C00100CCC0001C0C00C0CC00C10C010000C1C0C100C00C0001C010011C1CC01C0C0010100010C110C000100CC0000000CC1001C0C10C00010C00CC001C0C10C000000000C100000CC0C11C00C00000C0111000C000C00C0C1110111C00CC0C00100C0C101C0C1CC00C1000011C00C011C00C00001C00C100001C00C0C0C0CC0C0000C010C000C00CC0001C11C011000C10010C1C000C0011C0110C000C000000C00C01000C00C000C1C00001C01C00000C00CC0C1000001010000011000C000000C10C00C1000000110001111011000CC00000000000C0C1000C00C00C1C01100000100000000C1C101111000C01000101100000000C0000000CC10000000110C0000C10C000000000CCC01010C0CC1C100C00C0C0110100C01C00000000100C10C01100C10C000000C0000010C011CC0C00111001C10C0C0010000C110001000C1CC00C00C001C00CC000C011010111001100000001C000C00000C100C0110100001C100C0C0000010C000C1C000010C10C0C010C01001C0000110C010001C00C0C00001000100C0000000C000010101C0010C00000000000CCC00000C00C0100000110011C10000001C100C110000CCC110CC00000C00100C0C1C1C00100C0CC000CC00001000C0C0010000C0C000100000010C0000C00000100101
10100C00101C000100000000001C1C000010C001000100C000CC0000000C10C0CC0010C0000001000C001010100000001C00101100000C0C000C100C0010000C000000C000C000C0C0CC1CC0C0C0100010010C0C000100000100000C00CCCC00010C1010C00000C10101C00CC00110000000110000CCC0C00C00C01000C00000C1010000C0C0001C0C10C0010010100CC0C0000C000C0CC100001000100C01100CC110100C10C01000C0CC00C001C000CC00CC0010C000C0010C0010110CC10010C1C0C001000000010100CC0C1000010CC0C00010100C0C11110001C100110C10000C01C01C0000C0C00CC000000001010000C00C00C00CC110001C0111C0001C0C01C0C0010C00000CC00000C011C0C00C1000000001000000CC01C0010CC010011100100C0000000C01C0000000C0C01CC001C1C00010000100000100100CC1100000C001000CC011011100001CC0C111010001C100100111C1000000C0110000010000CC00C0000010100000C0C0C1C01000010100CC0001001000000000000000C00000CC00C0011C000C00000000CCC01001C0C010011000C1000011000C00101010CC0100100001000CC00C0100000C00001C01C01000C10C1010000001C0001C0CCC10C010001100000100C0000010CC011C10000100C001010000001CCC0000010C000001000C00C1C00C1001C000C1
1C010100000000C100000001001C0CC0101C00110000000110000010100C10C0001000010001CC01C1001010C100010C0C00C00C10000C01C010000CC0000CCC11C1C0C000C00C0100010001C0C000CC0C0011C0100C110C0000000000100000001000C0001100C00000C10C0000C0000C010C1000000000101C1110100000000000110C0C00010C100100000010C0CCC000001000C000C0000C000C1C0000010C0000C110000CC0C00C00000C0000100C000000C000C101C00CCC0C00C0C01000000C11C1C00C001000C11000000C100CC000110001010010C00C0000C1CC0000010100C100000100010C010101C1C1C0110001C10110000000100C001C01001000001100CC11100C000000C1C0011C11101000001000C0C00100C000000C001CC00110000C0CC0000CCC0100C0101C0C0001000001000000000100C000C00000C00C0C001100C001000000C001C00C00000110CC0000CC1CC00CC0100010C00CCC000C000C000C1001C110C00C01100CCCC00C000C00C000100C0C110C0CCC1010C01C01000000CC010C0110010C110C0C10000110C00C10C11001011C0C0C1C01C0001000010010C1000C010C11000000CC1C11000CC0001000000110010C00C010010000C0100000CC000C00000C0100CC000C000C0C101010C01101000000001C11C000010CCC00C1000000000001010001
1C0000010C0C0C0000C0C01000000CC10010010C11100100111CC01011C00C00010C100000C1000000C00000000000C1110010001CC000C00000010C0C000C0CC0C0C1C000001C01011010000C0000001C00C0000001100101000000C000111C01C0C0100C00000011CC00011C01C0C00000110001C0C01C00100010000C0001000C000C0010100C00C0000000C110010C01010C00C00010100C1C1C0000C0100CC000000CCC000000000C1000000C1C00000CC01000000C000000000100CC1C000C10011110000C011CC100010100100100C1000C01C0C11C0001CC00000C01C0C00100C0C00C00000C011000CC010C0CC01101000CCC0CC00000101110C100100000C010001CC101C00010C00C0010100000C0C001CC11000C10C0000100011CCCC10C00010010001000C00C10000000010010CC001110011001000000CCC10000C00C1000101111000C1110010C000C000000CC00CC00000000C11001C00C101000000C100CC00C1C011CC010100010C1010C0100000100C0CC1001C11000000C00CC10C1C100000C0C001C00C000000000C1000110C0C0100100010110011C01C10101C0C00C000C0010011C0C1010C0C0010100C0000C0011CC0C001000C0100110C1C1001000000C0000001011000C01000000C0100100C00C010101100C0C0000000000100C0000000C0CC10C101C11C1
11001C0010CCCC0000001000001000001000C0110100000C10C00000CC1000001CCC0000100000000100C0C1C01C00000111C010000101C101110C0110C000001000C0C00C100100C0CC00C0100C11000C0000C00C0000000000C00C0010000000000C011000C1100101CCC0C00C00C01000C0000011C0100C0C0011C000000C110000000C00001CCC0C0C1C010C1100C01100101C0000C0000010C000C0C00CC010100000001000010000C1000CC01C01CCC000000C0C00001110C1000C0001100000001C000000C0CC0C0C1C0001000C000CC1CC0C01C0000CC0CC0C010001CC1C0010C00C1CC0000C0000000C01000C100C00000101100001000100C001010C0CCC00100000000C000100C0000CC0010001000C000CC0CC00C010CCCC00001001C10110C01100CC0010C00C0000000000C010C1C00C10010CC01C010010101000C100C000000C001000100011010000C0C00C0CC0C010C00010C0000011C0C1000001C00CC000C0001110000010C0000CC00C00000000001000110CC000000011110000000C000C0CC1C00C0C100100C00C0C01000001000C100001110C0010110001C000001CC0000C000011001C0000C00000000CC101100000CC1C000100101011C0010C1001C010C0C0C1100001C00CCC00CC1C1110010000C010110C10C0C000C1000C0000C01C0000CCCC0010010C11
11001111C0100000C0111100000011C100CC01000C0C0000CC110C0CC00001CC00000001000CC000010100CC0C100010001000C01000C10C01C0000000100101001C000C0C00000000000C00100CC100C0000000000101CC111C1C001000000101C000100C10001C0C00C0C00110011010011000101C0C00010011000010C100100000001C0000111001C000C001100C00000100C000001C00C000C0100C0000CCCC001CC000C11101101000C0000010000C0CCC0010000CC1011000010000100C01C111000C001000100000C1100C10C01011000C10C1C000C1000101101000110001C0000C011CC000000000101010110C1001C0000CCC00000001000000101000C000010CCCC0C00100C01C00C0CC0CC00000001001C000CC0C0000C10011C000C1100110C000101000C00011000C0CC100C00101C0110C10000010CCC00CC001CC00001010000100C0000000001011000010000000C100C1000C00101000C0100C1C010C100110001010100100010010000CC00CCC000011C0000C010CCC101C0000C000C0C000C01000100101CCC00C000C000C00101000CC0100000001C10001CCCC1001001C100CC01100010C001C0C10000000C0C0000000C0001010C0100CCC0001000000C000010000C1110CC000C00110000010C111C0C010000C11000C011CC000000000000000110010C10CC001
11CCC0C10C000C10011100C0000CC100C000011101C1C000000011C01C1110000CC0C000000000C10000000101101C0111C1000001000CCCCC11CC001C001C10C10CC100C011100010000C000CC00C010C001000CC0000000010000010011010010000000C0C00001000100000C100C1100001001011000C1100000100C001CC00010000C0C001C001100010C000000010111C100000001110100001100010001C010000100000C10CC01C1000100C100C0C10CC010C0100C001C0100C00110CC0111110C000000100CC001CC000000CC1C00C00000C0CCC0000001CC0000CC00C00000010101000000000C100C00C000C1000100C0001100001000C0000C00CCC10C000100C10000C000000000C00100C0C0000000C0001C010010C1C0C1C100100001001CC0C00C100000CC0000000001000011C0C01001C010100000011C01C1C001000000CC1001000CC1001C001C1100C00C000C00C0100C0001C0000C111011CCC0CC00010C0001001001010100C00100C00100001CC0010C11000001001101010001100C01000C001010100000CC011100C0C110C00110010C00001CC00C000100011000000000C1C00000000001C0010001C10110C0100000110100CC1C00000101100CC00C01000CC0000000100000011C0000C0C0100000C0100C00000C0100C0101CC10100CC001C00000C1100001
11C0010C001CC01CC000000100C0000C001C010C0000000C01000100000000100010000C0C10C0C100000CC0C001010001110CC01011C001100000C01010000000CC1C001100000001000C0C000001C00000001000001CCCC10010C100000011000000C0C10001CC0100C000C00C11100C00000C000100000000101CC11CC00C0C001000100C0CCC00C0011C00C01001C000100CC00C00110C00CC01011000100C00C00000010C000010CCC100C0110000011CC00CCC1C0CCCC00110000CCC101C00000C100C00C011000C000C010C01C0001C0C000110C11CC0100C0000010111C11CCC10011C001C10001CC0000C10C000C00CC00100C1C0000000C0C01C1001110C00CC01C0C00100C00000C100CC00C10010000C00C000001CC0C001001110C0C00C0CC01CC0100C0C000010CC0100C0000CCC0C100CC00C00C000100011000C0000C000110110C110C0001011000111000CC0C0C0000000001C01C1000010010000C01000010CC00C100CC100110C010C0C01CC0011100C0000C10C100000110C0C00C00C00001C1001000001C010000C0C001000C0100000110100000C0C000010100C0000110C1001010000CC000000C000C100C00C01C0100001100001C110000000010100C0C10C00010000CC1C01000CC0CC0C000001C0C00C000C0C11011100111010000C00C01C0C000001010011
1C000CCC1C100000010000C100000CCC00110C0C0C0CC00001C01010000CC1001CC1C01C10001000000C0000000000C00001000100000010010000CCC001C0100C000C000010001CC1000C0000000C1000C0C0001100000CCC0000CC010CC100CC0000100C010000C0010001C0100C0110C0C0C1000C010000C01C10C00C0000C00C010000010C101CC000CC0C000C0000000001010100C0C01C0101CC01C111101C1101000C010C001CC000000C10C0100000CC0011C01100000C000000C1C00C1010001C000010C10100C010001100C0100C0000010C010C010000000001C0C00C0C0C001000000000001010C1CC0C100C0011CC100100C001000C0000100000100CC011100C001C1010CCC00CC000010111001100110C010010C0C00010000000100000C0001000C0C0101100001000000010C1001C0000101C00C10C0C10100010C11000001000101C10C0100CC000000C00000C1C001C00C00C00C1C00C10000C011101C00C00C10C100000010C000C00C00010000001100001010C100CC1C0110CC000000000010000C011010C01000C00000C000100C0000011000C0101010100C000001010C00010001C100C0000101C0C0C00000110010C00010000010C1C1C0C0000000CC000C00C00001C000CCC1C00C1C000C010000C0100010000C000C000C0C1C01C000C11100011100C001001
100C00C000CC00C000000C100000000C0C1000C0000C00100CC11101C000000C0C000010010C1101C0C100001C1011000010C00010C010C1000100000CC10CCC10C00000C000000000000101C1001C0C00C1C00C00110C00C010000100000000C01C0C01C1000000000C10100CC00C00C0001CC0C01C00C0000101001010110C1000C10C0C00C00010CC0001C00000001100001C11000001010001C000CC000C01000C00C1C1CC00001010000C1C100C1C00010010000010100001000010C0100101C1100C0000CCC0000011C0C0CC110000C001CCCC10000CCC0011CC00C00C0C1000000C110010CC00C0C0000001000C10100CCC0C1CC000101C01C0100000000000C01C00000001000000000C0C0110000C101CC00100C100011110C110101C00000000110010000000C010C010010C10110CC01C00001000001101000000C01001C0CC0011C1C0CC111CC1C000000C000000001C110100010C0C100CC0C00000100C0C010101100C0001001C001C00000101C0000000C0000000010C01000C10000C0C0100001C10100000100000001C10C00000000010010C010C100001000C1000000C00C0CC1010C100000C011C111CC000C10CC10C01101C10C00001100000C0010000C000C0C100001001C0000101C0C0110CC0C000CC0C1CC0000000000C0CC11101C0CC0000C00100C10000001001
10C00C0CC0C0C10C0011CC000CC0C0000C1C1CC00C01010010000CCC00001C00000C000CC010C1C000100001001100000100010CC0CC000C00100CC000110CC011010000101C01C00CC0010C0110100C010C1C0000100C10100001C10010C0C0C1000C000101C01000000000C100C0C00C0C000C0100C0001CC00C0101010000001C00010CC000C00CC0C00C100000C010110C000CC010C00000000000111001010000C0001C00000CCC0100010CC000C001000C0C10C011010C10CC0010CC0000C10110010C0C0001C010C00100CC0000C01C0CC000C010000C10C1010CC0C01000C00CC00000100100CCC101C0101001000CC1101000010100000CC1CC010CC00101C001C000C01110000100C0000C00000100C0C000000100000000CC000011011000C1C01C001C00C0000010010000C000C0C0C00C100000100010C00000010C00110C01C0110C0101C0001000C00000110001C100001000100011101000000010CC0C00CC1CCC00C00000010100010C01000C0010000000C000100C0100110CC0110CC01100010C00001011110C0001010000C1000010000C000111C01000CC000C010010C0CC1000C00C0000010C10CCC100011C0100000C0C000011CCC0C0000C00000000111010CC00C001000CCC100C0011CC010001C00110C0000C0C0C1000000000000010CC0001C10CCCC00C00C1
110C00C1000C100000000C000C000101000CC0C000C01111C000CCCC001C00C1C0110101000011CC0100C00C0C000011010100000000C000001100000C0010C1C0C0010000C10000C0001C0CC00C0000000C001010C00C001C1CC0000C1000C1101000001010001010C00000C100C1C0000C0C1110C0C000000011C00010100100C001C1C0C00001010110100000CCC00011000110C0000100100C00000000001C01C10001CC000C0011C00C00000C1C00000000100C0010100CC00C10000000C0C00010010000C000010000C010000100C0C0C11CC0C0000011110100001C0001000100C010000000000C00100C100000C00CC1010C01C1100010100C0001100C11CCC001C10000C00C0001C1CC100CC10001C00C000C10C01C00C00001C10CC000000110000C00000C10CC00100C000C1CC01000C000110000010000010C01011C0C0110000011000000C00C100C0000000001110000001000CC00010C01CC0C0000000011C00000C0010C0100CC00001100000CCC00101010C0C00100000000001000011011CCC0101010C000100000111000000C0C10C00C100C11C100110C0C10C011000CC1CCCC0C000100100CC0000C10010C00C10C01C00C0C000C1100C00000C0C101100CC00C11100C10000CC0C0000C10CC0000000CC0000001000001CC000C1CC100000C000001C1000000000101
1111111111111111111111111111111111111111111111111111111111111111111111111111111111111111111111111111111111111111111111111111111111111111111111111111111111111111111111111111111111111111111111111111111111111111111111111111111111111111111111111111111111111111111111111111111111111111111111111111111111111111111111111111111111111111111111111111111111111111111111111111111111111111111111111111111111111111111111111111111111111111111111111111111111111111111111111111111111111111111111111111111111111111111111111111111111111111111111111111111111111111111111111111111111111111111111111111111111111111111111111111111111111111111111111111111111111111111111111111111111111111111111111111111111111111111111111111111111111111111111111111111111111111111111111111111111111111111111111111111111111111111111111111111111111111111111111111111111111111111111111111111111111111111111111111111111111111111111111111111111111111111111111111111111111111111111111111111111111111111111111111111111111111111111111111111111111111